######################
#          #        ##
#  $   .    #  $     #
#     $.    #       ##
####   @         #####
   ######   . . #
        ########
