####################
#                  #
#                  #
#     ####         #
#     #  #         #
#     #$ #         #
#     #  #     #####
#  ####  #######   #
#  #   $  $        #
#  #   #$$#   ##   #
####  $#  #  #  ####
   #  #   #  #  #
   ################
